Sujet: vous payez trop pour les meds.
Avoir une condition.
Si vous avez besoin d’un des médicaments ci-dessous.
Économisez jusqu’à 80 ici:
Http://www lvsdfbefd info 92.
Allergie: claritin zyrtec.
Antibiotique: asacol ceftin cipro tequin.
Anti depressant: celexa effexor paxil prozac remeron zoloft.
Anxiété: buspar valium xanax.
Arava rheumatrex: arava rhumatrex.
Pression artérielle: altace avapro cardizem cozaar flomax norvasc plavix.
Os et articulations: fosamax.
Cancer: nolvadex purinethol.
Cholestérol: lipitor pravachol zocor.
Diabète: actes avandia glucophage.
Perte de cheveux: propecia.
Headhache: imitrex.
Brûlure cardiaque: aciphex.
Hépatite b: épivir.
Herpes: neurontine.
Vih: rétrovir susactive videx viramune zerit.
Muscle relaxant: soma.
Nausea: zofran.
Soulagement de la douleur: bextra celebrex vioxx vioxx.
Saisies: lamictal.
Santé sexuelle: cialis viagra.
Peau: oxsoralène.
Aide au sommeil: amoureux.
Fumer: zyban.
Malaise estomac: nexium prevacid prilosec.
Perte de poids: meridia.
Santé des femmes: diflucan evista.
Ladybug frogsrugby rhonda barry.
Tequila crackerkingdom shawn sarahl wright scubal josh.
Ledzep angels jimbo.
Centre naomiscarlett impala hanna.
Septembe de vol astérix.
Rhonda playercarlos raptor taffy.
Roy kissdodgers planet sugar tintin sucré utopie.